S000000000
0111111110
010T000010
0101111010
010T011110
0111111010
010T000000
0000000000
00000000E0
1111111111