S000000000
0111111110
010T000010
0101111010
0100011110
011100000E
0100T00000
000000T000
000000000T
1111111111