S000000000
0111111110
010T011110
010T000010
010T111010
0111011110
010T0000E0
0000000000
0000000000
0000000000
