S000000000
011T111110
0100000010
0100000010
010TTT0010
0111111010
010000000E
00T0000000
0000T0000T
0000000T00