S000000000
0111111110
010T000010
010T111010
010T000010
0111111010
0100000T0E
0000000000
0000000000
0000000000
