S000000000
0111111110
010T011110
010T010010
010T011110
0111011110
010T000000
0000000T00
0000000000
000000000E
