S000000000
0111111110
010T000010
0101111010
0100011110
0111111010
010T000TT0
0000000000
000000000E
TTTT01100T