S000000000
0111111110
0100000010
0101111010
0100000010
0111111010
010000000E
0000000000
0000000000
0000000000
