S000000000
0111111110
010T011110
010T000010
010T011110
0111000000
010T0000E0
0000000000
0000000000
0000000000
